辞書に登録予定の単語	備考
gf	gttnの口語形  
twn	twanstnの口語形の現在分詞  
drāwrdn	現在のカテゴリーに存在していない  
pyr	形態素タグが元々lexファイルにも存在していないケースも多いようだ．しかし，何もないでは問題なので，何かかんがえないと  

辞書に登録済みの語	備考  
dndwn	N5:c  
šykm	N1:c  
šykar	N1:c  
lwne	N5:v  
xwne	N5:v  
zmstwn	N5:c  
embwne	N6  
palapal	N1:c  
bza	N5:v  
bzbza	N5:v  
āŕajan	N5:c  
dwne	N5:v  
danedane	N5:v  
barkalle	OHにinvとして追加  
awww	INTに追加  
barwn	N5:c  
xwšbaši	ADJとして登録  
slmany all	
ŕaym	形 直立の  
qrbyl	名詞　ふるい  
pltyky	名詞 詐欺  
yal	名詞　たてがみ  
ptpt	形容詞  
čydn	摘む　all v22が適切かと  	
rystn	動詞 all v11とv22の両方とも適切
kwbydn	動詞 たたく v1とv18が適切 
ţy	名詞　前進  
šdn	動詞 v23にも追加  
mħtawy	名詞 all
alaq	名詞 all  
qrwb	名詞 all
teye	名詞 all

#PerDep用に追加
āya	PART
mgr	PART
ke	PART
ra	PART
āxr	PART
dygr	PART
ya	PART
xwb	PART

ra	0;Lemma;P;;cat=POSTP;%default	# For PerDep
rw	0;Lemma;P;;cat=POSTP;%default	# For PerDep
dr	0;Lemma;P;;cat=POSTP;%default	# For PerDep
emrae	0;Lemma;P;;cat=POSTP;%default	# For PerDep
w	0;Lemma;P;;cat=POSTP;%default	# For PerDep
drbarX	0;Lemma;P;;cat=POSTP;%default	# For PerDep
ħdwd	0;Lemma;P;;cat=POSTP;%default	# For PerDep
knar	0;Lemma;P;;cat=POSTP;%default	# For PerDep
az	0;Lemma;P;;cat=POSTP;%default	# For PerDep
jlwy	0;Lemma;P;;cat=POSTP;%default	# For PerDep
pyš	0;Lemma;P;;cat=POSTP;%default	# For PerDep

če	inv	0;Lemma;DETquant;;cat=QUAJ;%default	# For PerDep
če_	inv	0;Lemma;DETquant;;cat=QUAJ;%default	# For PerDep
čnd	inv	0;Lemma;DETquant;;cat=QUAJ;%default	# For PerDep
kdam	inv	0;Lemma;DETquant;;cat=QUAJ;%default	# For PerDep
kdamyn	inv	0;Lemma;DETquant;;cat=QUAJ;%default	# For PerDep
'jb	inv	0;Lemma;DETquant;;cat=EXAJ;%default	# For PerDep
če	inv	0;Lemma;DETquant;;cat=EXAJ;%default	# For PerDep
čgwne	inv	0;Lemma;DETquant;;cat=QUAJ;%default	# For PerDep

čnd	0;Lemma;DETquant;;cat=AMBAJ;%default     # For PerDep
er	0;Lemma;DETquant;;cat=AMBAJ;%default     # For PerDep
dygr	0;Lemma;DETquant;;cat=AMBAJ;%default     # For PerDep
eme	0;Lemma;DETquant;;cat=AMBAJ;%default     # For PerDep
b'źy	0;Lemma;DETquant;;cat=AMBAJ;%default     # For PerDep
čndyn	0;Lemma;DETquant;;cat=AMBAJ;%default     # For PerDep
eman	0;Lemma;DETquant;;cat=AMBAJ;%default     # For PerDep
čndy	0;Lemma;DETquant;;cat=AMBAJ;%default     # For PerDep
eyč	0;Lemma;DETquant;;cat=AMBAJ;%default     # For PerDep
ezaran	0;Lemma;DETquant;;cat=AMBAJ;%default     # For PerDep
brxy	0;Lemma;DETquant;;cat=AMBAJ;%default     # For PerDep
mylywn_ea	0;Lemma;DETquant;;cat=AMBAJ;%default     # For PerDep
şdea	0;Lemma;DETquant;;cat=AMBAJ;%default     # For PerDep
'de_ay	0;Lemma;DETquant;;cat=AMBAJ;%default     # For PerDep
eyč_	0;Lemma;DETquant;;cat=AMBAJ;%default     # For PerDep
flan	0;Lemma;DETquant;;cat=AMBAJ;%default     # For PerDep
de_ea	0;Lemma;DETquant;;cat=AMBAJ;%default     # For PerDep
mŕdary	0;Lemma;DETquant;;cat=AMBAJ;%default     # For PerDep
če	0;Lemma;DETquant;;cat=AMBAJ;%default     # For PerDep
tnea	0;Lemma;DETquant;;cat=AMBAJ;%default     # For PerDep
emX	0;Lemma;DETquant;;cat=AMBAJ;%default     # For PerDep
xyly	0;Lemma;DETquant;;cat=AMBAJ;%default     # For PerDep
tk	0;Lemma;DETquant;;cat=AMBAJ;%default     # For PerDep
gaey	0;Lemma;DETquant;;cat=AMBAJ;%default     # For PerDep
akçr	0;Lemma;DETquant;;cat=AMBAJ;%default     # For PerDep
mylyardea	0;Lemma;DETquant;;cat=AMBAJ;%default     # For PerDep
čndan	0;Lemma;DETquant;;cat=AMBAJ;%default     # For PerDep
klyX	0;Lemma;DETquant;;cat=AMBAJ;%default     # For PerDep
kmy	0;Lemma;DETquant;;cat=AMBAJ;%default     # For PerDep
bsyary	0;Lemma;DETquant;;cat=AMBAJ;%default     # For PerDep
kmtr	0;Lemma;DETquant;;cat=AMBAJ;%default     # For PerDep
t'dady	0;Lemma;DETquant;;cat=AMBAJ;%default     # For PerDep
sal_ea	0;Lemma;DETquant;;cat=AMBAJ;%default     # For PerDep
pare_ay	0;Lemma;DETquant;;cat=AMBAJ;%default     # For PerDep
čndşd	0;Lemma;DETquant;;cat=AMBAJ;%default     # For PerDep
eme_	0;Lemma;DETquant;;cat=AMBAJ;%default     # For PerDep
ewar	0;Lemma;DETquant;;cat=AMBAJ;%default     # For PerDep
srasr	0;Lemma;DETquant;;cat=AMBAJ;%default     # For PerDep
an	0;Lemma;DETquant;;cat=AMBAJ;%default     # For PerDep
čndmyn	0;Lemma;DETquant;;cat=AMBAJ;%default     # For PerDep
grwey	0;Lemma;DETquant;;cat=AMBAJ;%default     # For PerDep
čŕdr	0;Lemma;DETquant;;cat=AMBAJ;%default     # For PerDep
bsy	0;Lemma;DETquant;;cat=AMBAJ;%default     # For PerDep
bsyar	0;Lemma;DETquant;;cat=AMBAJ;%default     # For PerDep
andky	0;Lemma;DETquant;;cat=AMBAJ;%default     # For PerDep
erče	0;Lemma;DETquant;;cat=AMBAJ;%default     # For PerDep
 
